#####M####################C#######
##### #################### #######
#####       ############## #######
#####     ################ #######
##### ## ################# #######
##### ##               #   #######
##### ## #########################
##### ## #########################
##################################