#####C############################
##### ############################
#####       ##############M#######
#####     ################ #######
######## ################# #######
########                   #######
################     #############
### ##############################
##################################